1111111111
100ECPC001
1000000001
1111111111