1111111111111111
1P00000000000001
1001100000011001
10100100C0100101
1010010000100101
1001100000011001
1000000000C00001
1000000110000001
10010C0000001001
1001100E00011001
1000111111110001
10C0000000000C01
1111111111111111