11111111111111111111
10000000111100000001
10000000111100000001
10000000111100000001
100C000011110000C001
1011110000E000111101
10111100000000111101
10111100000000111101
10111100000000111101
10000000000000000001
10111100000000111101
10111100000000111101
10111100000000111101
1011110000P000111101
10000000111100000001
10000000111100000001
10000000111100000001
1000C0001111000C0001
11111111111111111111
