11111111111111111111
10000000000000000001
10000000100100000001
1000000010C100000001
10000000111100000001
1011110000E000111101
10000100000000100001
1000C1000000001C0001
10111100000000111101
10000000000000000001
10111100000000111101
1000C1000000001C0001
10000100000000100001
1011110000P000111101
10000000111100000001
1000000010C100000001
10000000100100000001
10000000000000000001
11111111111111111111
