11111111111111111111
10000000001100000001
10001111001100011001
10011111C01100011001
10000000111000011001
1011110000E0001C1101
10111100000000101101
1C111100000000100001
11111100000000111111
10000000000000000001
11111100000000111101
10000100000000111101
10110100000000111101
1011C10000P000111101
10011000111100000001
10011000110C11111001
10011000110011110001
10000000110000000001
11111111111111111111
