1111111
1P10001
101C101
1010101
1000101
11111C1
1C00001
1110111
1C101E1
1000001
1111111
