1111111111111111111111111111111111111111
1C10101010101010101010101010101010101C11
1000000000000000000000000000000000000001
11010101010101C1C101C101C101010101010101
1000000000000000000000000000000000000001
1010101010101011010101010101010101010101
10101C1011001010111010101100101011101101
1101C101010101C1010101010101010101010101
1C010010010C1001001001001001001C01001001
1101010101010101010101010101010101010101
1000000000000000000000000000000000000001
1010101010101010101010111010101010101011
1001C010110011001100110C11C0110011001101
1101010101010101010101010110101010101011
1000000000000000000000000000000000000001
1010101010101010101010111010101010101011
1001C010110011001100110C11C0110011001101
1101010101010101010101010110101010101011
1000000000000000000000000000000000000001
1010101010101010101010111010101010101011
1001C010110011001100110C11C0110011001101
1101010101010101010101010110101010101011
1000000000000000000000000000000000000001
1010101010101010101010111010101010101011
1001C010110011001100110C11C0110011001101
1EP0000000000000000000000000000000000001
1111111111111111111111111111111111111111
