1111111111111111111111111111111111111111
1000000000000000111111110000000000000001
1000000000000000111111110000000000000001
1000011111000000111111110000001111100001
1000011111000000111111110000001111100001
1000011111000000111111110000001111100001
1000011111000000111111110000001111100001
1000000000000000000000000000000000000001
1000000000000000000000E00000000000000001
1000000000111110000000000111110000000001
1000000000111110000000000111110000000001
1000000000000000000000000000000000000001
1001111111100000011111100000011111111001
1000111111000000011111100000001111110001
1000001100000111111111111110000011000001
1000111111000000011111100000001111110001
1001111111100000011111100000011111111001
1000000000000000000000000000000000000001
1000000000111111111001111111110000000001
1000000000000000000000000000000000000001
10000C0000000000000000000000000000000001
1000000000111111111001111111110000000001
1000000000000000000000000000000000000001
1001111111100000011111100000011111111001
1000111111000000011111100000001111110001
1000001100000111111111111110000011000001
1000111111000000011111100000001111110001
1001111111100000011111100000011111111001
1000000000000000000000000000000000000001
1000000000111110000000000111110000000001
100000000011111000000P000111110000000001
1000000000000000000000000000000000000001
1000000000000000000000000000000000000001
1000011111000000111111110000001111100001
1000011111000000111111110000001111100001
1000011111000000111111110000001111100001
1000011111000000111111110000001111100001
1000000000000000111111110000000000000001
1000000000000000111111110000000000000001
1000000000000000000000000000000000000001
1111111111111111111111111111111111111111