111111111111111111111111111111111111111
1C011C011C011C011C011C011C011C011C01101
110011001100110011001100110011001100111
111001100110011001100110011001100110011
110001100000111100001111000011110000111
110000111100011111000011110000111100111
1000011000110110000111C0011100011000001
100011000011000000011000000000011110001
110000000111000110011111000001110000001
110000000110000000001111100011110011001
111C01110001C00000011110000011100011001
111111100001110000111100011C00000110001
111001110001111000111110011110000000001
100000110000111000000000001100000000001
10000000000011000011100000111C000000011
100000000001100000111100011111110000111
110000000011100000C11100000111000001111
11100011000C000111110000000111100000001
11P0000000000001111111111111100000000E1
111111111111111111111111111111111111111
