111111111111111111111111111111111111111
1P1000100000000000000000000000000000001
101010100000000000000000000000000000001
101010100000000000000000000000000000001
100010100000000000000000000000000000001
11111C100000000000000000000000000000001
1C0000100000000000000000000000000000001
111011100000000000000000000000000000001
100010000000000000000000000000000000001
101111100000000000000000000000000000001
100000000000000000000000000000000000001
111110100000000000000000000000000000001
100000000000000000000000000000000000001
100000000000000000000000000000000000001
100000000000000000000000000000000000001
1000000000000000000000000000000000000E1
111111111111111111111111111111111111111
