111111111111111
111000111000111
1100P0010000011
10000000000C001
10C000000000001
100000C00000001
11000000000C011
111000000000111
11110C000001111
11111000C011111
111111000111111
1111111E1111111
111111111111111