111111111111111111
1E00000000000C0001
101001011010010101
101001000010010001
1P00000000000000C1
101001000000010101
1000000000000000C1
101001000010010101
1000000000000000C1
101001000000010101
1000000000000000C1
1000000000000000C1
101001000000010101
1001000000000000C1
1000000001110000C1
101001000000010101
1000011101100000C1
1000000000000000C1
1000000000100100C1
111111111111111111