111111111111111
1110P0111000111
110000010000011
10000000000C001
100000000000001
100000C00000001
110000000000011
111000000000111
111100000001111
11111000C011111
111111000111111
1111111E1111111
111111111111111