1111111
1P0C011
1000CE1
1111111